::::::::::::::::::::::::::::::::::::::::::::::::::::::::::::
::         Tutorial levels for Extended Sokoban           ::
::               By Fernando Carmona Varo                 ::
::::::::::::::::::::::::::::::::::::::::::::::::::::::::::::


A simple start

______
-
@ #$.-
______

Just a simple quick level showcasing the basic mechanic
of placing the box in the goal.


Slippery

~~~-~~
~~~~~~
~~~~~~
&~~$~~
~~~~~~
~~~.~~

Slip stoppers

@------
-~~~$~-
-~ ~~~-
-~~~#~-
-~~~.~-
-~#~~~-
-------

Open up

###########
#   #   #k#
# #   #   #
#  #   ####
## ##   ###
#  #  #k###
# ## ######
#k#      @#
########K$.
